11111111111111111111
100000000E1000010001
1000010001N000011001
100011111000P0111101
10111110000000000011
11111111111111111111
