11111111111111111111
100000000E1000010001
10P0010000N000011001
10001111100000111101
10111110000000000011
11111111111111111111
